NO ./assets/textures/biohazard/xpm/environment/wall_north.xpm
SO ./assets/textures/biohazard/xpm/environment/wall_south.xpm
EA ./assets/textures/biohazard/xpm/environment/wall_east.xpm
WE ./assets/textures/biohazard/xpm/environment/wall_west.xpm
FL ./assets/textures/biohazard/xpm/environment/floor.xpm
CE ./assets/textures/biohazard/xpm/environment/ceiling.xpm
XX ./assets/textures/biohazard/xpm/enemies/enemy_0.xpm

111111111111111111111111
100000000000000010000001
101000000000000000000001
101000000000000000000001
101000000000000010000001
101000011111111110111111
101000010101010110001111
101000010000000010000001
101000000000000000000001
101000010000000010000001
100000010000000010001111
100000011110111111111111
111111111110111111111111
100000000000000000000001
111111011110111111111111
111111011110111111111111
100000000011011000001001
100000000000110010001001
100000000011011000011011
101010000011000010X00001
100100000011011000011011
10101000001101101E0Q1001
100000000000X00000000001
111111111111111111111111