
NO ./assets/textures/biohazard/xpm/environment/wall_north.xpm
SO ./assets/textures/biohazard/xpm/environment/wall_south.xpm
EA ./assets/textures/biohazard/xpm/environment/wall_east.xpm
WE ./assets/textures/biohazard/xpm/environment/wall_west.xpm
F 200,210,148
C 246,001,054

111111111111111111111111
100000000000000010000001
101000000000000000000001
101000000000000010000001
111111111111111111111111