NO ./assets/textures/biohazard/xpm/environment/wall_north.xpm
SO ./assets/textures/biohazard/xpm/environment/wall_south.xpm
EA ./assets/textures/biohazard/xpm/environment/wall_east.xpm
WE ./assets/textures/biohazard/xpm/environment/wall_west.xpm
FL ./assets/textures/biohazard/xpm/environment/floor.xpm
CE ./assets/textures/biohazard/xpm/environment/ceiling.xpm

111111
100101
1010X1
1100E1
1Q00X1
111111
